3
1 7
@.A#a.!
5 5
@####
....#
#..##
A.###
##a.!
11 10
@#########
.#a#b#d.##
.#.#.#..##
.#.#.#..##
.#.#.#E.e#
.#.#C#f.F#
.#.###G.g#
.#.#c#h.H#
.#.#.#I.i#
.#.#.#j.J#
A#B#D#K.k!