2
5
y....
.....
..g..
bgr.y
r...b
9
.........
.rlb.....
...lo.ob.
.......p.
.g.gr....
yp.....mu
.uy......
.m.......
.........
